50 _8N$
_____________________8____8_______________________$
______________8___________________________________$
__________________________________________________$
__________________________________________________$
__________________________________________________$
______________________________________________8___$
_____________________________________8____________$
______________________8__________________________8$
______________________8____________________8______$
_________________________________8_8______8_______$
_____________8_________8_________________________8$
__________________________________________________$
__________________________________________________$
__8________8______________________________________$
_______________________8_____________________8____$
____________________________8_____________________$
____8______8_____8___________8____________________$
_________________8________________________________$
__________________________________________________$
__________________________________________________$
8_____8___________________________________________$
_______________________________8_8________________$
__________________________________________________$
__________________________________________________$
________8_________________________________________$
______8_________________8_________________________$
_____8_____________________8______________________$
___________________________8______________88______$
____________________________8_____________________$
________________8____8____________________8_______$
_______8________________________________________8_$
__8__________8______________________8_____________$
_______8_______________________________8__________$
______________________8___________________________$
_____8____________________________________________$
___8______________________________________________$
__________________8__8___________8__8_____________$
__________________________________________________$
____8__8__________________________________________$
_____________________________________8____________$
_____________8_______88______________8____________$
__________________________________________________$
_____________8____________________8_8______8______$
_________8______________8_________________________$
_______8_____________8_______________________8____$
___________________________________8______________$
___________________8__8___________________________$
____8___________8__________________________8______$
__________________________________________________$
_______8__________________________________________$
